name=Default Dungeon
width=20
height=20
data=
2,2,2,2,2,2,2,2,2,2,2,2,2,2,2,2,2,2,2,2
2,1,1,1,1,1,1,1,1,1,1,1,1,1,1,1,1,1,1,2
2,1,1,1,1,1,1,1,1,1,1,1,1,1,1,1,1,1,1,2
2,1,1,3,3,3,1,1,1,1,1,1,1,1,2,2,1,1,1,2
2,1,1,3,3,3,1,1,1,1,1,1,1,1,2,2,1,1,1,2
2,1,1,3,3,3,1,1,1,1,1,1,1,1,1,1,1,1,1,2
2,1,1,1,1,1,1,1,1,1,1,1,1,1,1,1,1,1,1,2
2,1,1,1,1,1,1,1,2,2,2,1,1,1,1,1,1,1,1,2
2,1,1,1,1,1,1,1,2,1,2,1,1,1,1,1,1,1,1,2
2,1,1,1,1,1,1,1,2,2,2,1,1,1,1,1,1,1,1,2
2,1,1,1,1,1,1,1,1,1,1,1,1,1,1,1,1,1,1,2
2,1,1,1,1,1,1,1,1,1,1,1,1,3,3,1,1,1,1,2
2,1,1,2,1,1,1,1,1,1,1,1,1,3,3,1,1,1,1,2
2,1,1,2,1,1,1,1,1,1,1,1,1,1,1,1,1,1,1,2
2,1,1,2,2,2,1,1,1,1,1,1,1,1,1,1,1,1,1,2
2,1,1,1,1,1,1,1,1,1,1,1,1,1,1,1,1,1,1,2
2,1,1,1,1,1,1,1,1,1,1,1,1,1,1,1,1,1,1,2
2,1,1,1,1,1,1,1,1,1,1,1,1,1,1,1,1,1,1,2
2,1,1,1,1,1,1,1,1,1,1,1,1,1,1,1,1,1,1,2
2,2,2,2,2,2,2,2,2,2,2,2,2,2,2,2,2,2,2,2
